427,457,457,457,457,457,457,457,457
428,7,7,7,7,7,7,7,7
428,7,7,7,7,7,7,7,7
428,7,7,7,7,7,7,7,7
428,7,7,7,7,7,7,7,7
428,7,7,7,7,7,7,7
